######################
#.........##.........#
#.######.#####.####.##
#.#    # # #    #.#  #
#.# ##.#   #.## #.#  #
#.....##    .#.....# #
#####.#  ###  #.##### ##
    #.#      #.#     #
######.##  ## #.###### #
#......  o  ......#  #
#.#####.#####.#####.##
#....P........G.....##
######################
